1111111111111
1P010000000C1
1000011111K01
100011E0000C1
1111111111111